IEU = "countries/Iberian Union.txt"
FRC = "countries/French Commune.txt"
BNL = "countries/Benelux.txt"
ROI = "countries/Republic of Ireland.txt"
BRI = "countries/Britain.txt"
GDR = "countries/German Democratic Republic.txt"
PPR = "countries/Polish People's Republic.txt"
UOS = "countries/Union of Soviet Socialist Republics.txt"
BAF = "countries/Balkan Federation.txt"
ISR = "countries/Italian Socialist Republic.txt"
HPR = "countries/Hungarian People's Republic.txt"
KOD = "countries/Kingdom of Denmark.txt"
SRR = "countries/Socialist Republic of Romania.txt"
CSS = "countries/Czechoslovak Socialist Republic.txt"
ROA = "countries/Republic of Austria.txt"
SCF = "countries/Swiss Confederation.txt"
ROF = "countries/Republic of Finland.txt"
KOS = "countries/Kingdom of Sweden.txt"
KON = "countries/Kingdom of Norway.txt"
NAA = "countries/North Atlantic Alliance.txt"
NFR = "countries/New France.txt"
GCN = "countries/Great Canada.txt"
CCF = "countries/Canadian Confederation.txt"
OOL = "countries/Order of Liberty.txt"
ROT = "countries/Republic of Texas.txt"
ROH = "countries/Republic of Hawaii.txt"
SSA = "countries/Soviet States of America.txt"
PAR = "countries/People's American Republic.txt"
CSA = "countries/Confederate States of America.txt"
COS = "countries/Central States of America.txt"
FSA = "countries/Free States of America.txt"
RDL = "countries/Red Land.txt"
